PPPPPPPPPPPPPPPPPPPPPPPPPPPPPPPPPPPPPPPPPPPPPPPPPPPPPPPPPPPPPPPPPPPPPPPPPPP
P                                                                         P
P                                                                         P
P                                                                         P
P                 U                              PPPP   P                 P
P               PPPPPPP                      PPPP        P                P
P                                          PP        U   P                P
P                  E                  PPPPP          P   P                P
PC                 P                 P  U                P    P           P
P               FFFFFFF           E    FFFF       E     FFFP  P        B  P                                                                                          
PPPPPPPPPPPPPPPPPPPPPPPPPPPPPPPPPPPPPPPPPPPPPPPPPPPPPPPPPPPPPPPPPPPPPPPPPPP                                                          
