PPPPPPPPPPPPPPPPPPPPPPPPPPPPPPPPPPPPPPPPPPPPPPPPPPPPPPPPPPPPPPPPPPPPPPPPPPPPPPPPPPPPPPPPPPPPPPPPPPPPPPPPPPPPPPPPPPPPPPPPPPPPPPPPPPPPPPPPPPP
P                                                                                                                                         P
P                                                                                                                                         P   
P                      C                                         P                                                                        P
P                                                                P                                                                        P
P                    PPPPP     PPPP                              PPPPPPPPPPP                                                              P
P                                                                          P                                                              P
P          PPPP                                                            P                                                              P
P  P                                                             PPPPPPPPPPP                                                              P
P  P         FFFFFFF       FFFFF                             FFFFP                                                                        P
P  P   PPPPPPPPPPPPPPPPPPPPPPPPPPPPPPPPPPPPPPPPPPPPPPPPPPPPPPPPPPP                                                                        P
P  P   P                                                                                                                                  P
P  PFFFP                                                                                                                                  P
P  PPPPP                                                                                                                                  P                                                                                                                                         P                                                                                                                                         P
P                                                                                                                                         P
P                              P                              P                                                                           P
P                                                           PP FFFFFPPPPPPPPPP   PPPPPPPPPPPPPPPPPPPPPPPPPPPPPPPPPPPPPPPPPPPPPPPPPPPPPPPPPP
P                          PP                             PP   PPPPP                                                                      P
PPPPP                 PP    P                           PP                                                                                P
P        PPP                P                          P                                                                                  P
P                  PP       P          P              P                                                                                   P                                                                                    P                           P          P             P                                                P  P  P                             P
P                           P          P          FFPP                                             P  P  P  P  P                          P   
P                           P          P         PPPP                                           P  P  P  P  P  P                          P
P                           P          P        P                                             P P  P  P  P  P  P   P                      P                
P     FFFFFFFFFFFFFFFFFFFFFFFFFFFFFFFFFP      PP                                           P PPFPFFPFFPFFPFFPFFPFFFP                     BP
PPPPPPPPPPPPPPPPPPPPPPPPPPPPPPPPPPPPPPPPPPPPPPPPPPPPPPPPPPPPPPPPPPPPPPPPPPPPPPPPPPPPPPPPPPPPPPPPPPPPPPPPPPPPPPPPPPPPPPPPPPPPPPPPPPPPPPPPPPP

                                              