PPPPPPPPPPPPPPPPPPPPPPPPPPPPPPPPPPPPPPPPPPPPPPPPP
P                                               P
P                                               P
P                                               P
P                     C                         P
PE                                             EP
PPPP          PPPPPPPPPPPPPPPPP              PPPP
P                                               P
P                                               P
P                                               P
P                                               P
PFFFFFFFFFF                  FFFFFFFFFF         P
PPPPPPPPPPPPPPPP          PPPPPPPPPPPPPPPPPP    P
P                                               P
P                                               P
P                                               P
P                                               P
PE                   FFFFF         FFFF         P
PPP         PPPPPPPPPPPPPPPPPPPPPPPPPPPPPPPPPPPPP
P                                               P
P                                               P
P                                               P
P                                 P             P
PU                                P         B   P
PPPPPPPPPPPPPPPPPPPPPPPPPPPPPPPPPPPPPPPPPPPPPPPPP
