PPPPPPPPPPPPPPPPPPPPPPPPPPPPPPPPPPPPPPPPPPPPPPPPPPPPPPPPPPPPPPPPPPPPPPPPPPPPPPPPPPPPPPPPPPPPPPPPPPPPPPPPPPP
P                                                                              P                          P
P                                                                              P                          P
P                                                             U               EP                          P
P                                                            PP               PP                          P
P                                                                              P                          P
P                                                           P   FFFF           P                          P
P                                                            P  PPPPPPPPPPPPPPPP                          P
P                                                          P                                              P
P                                                            P                                            P
P                                                         P                                               P
P                                                        P                                                P                                                            PP                                                                                                        P 
P                                                PP  PP                                                   P
P                                            E PP      PP                                                 P
P                                            PP          PP                                               P
P                                          PP              PP                                             P
P                                        PP                  PP                                           P
P                                      PP                      PP                                         P
P                                    PP                          PP                                       P
P                                  PP                              PP                            P        P
P                                PP                                  PP                         P         P
P                              PP                                      PP                      P          P
P        UP                  PP                                          PP                   P           P
P        PP                PP                                              PP                P            P
P                         P                                                  PPE            P             P
PC      E       E                               FFFFFF                         PP     E    PFFFFFF       BP 
PPPPPPPPPPPPPPPPPPPPPPPPPPPPPPPPPPPPPPPPPPPPPPPPPPPPPPPPPPPPPPPPPPPPPPPPPPPPPPPPPPPPPPPPPPPPPPPPPPPPPPPPPPP

