PPPPPPPPPPPPPPPPPPPPPPPPPPPPPPPPPPPPPPPP
PC                                     P
P                                     BP
PPPP                                 PPP
P                                      P
P    PPP                            PPPP
P                                      P
P          PPP      PPPP PPPPP PPPPPPPPP
P                                      P
PFFFFFFFFFFFFFFFFFFFFFFFFFFFFFFFFFFFFFFP
PPPPPPPPPPPPPPPPPPPPPPPPPPPPPPPPPPPPPPPP