PPPPPPPPPPPPPPPPPPPPPPPPPPPPPPPPPPPPPPPPPPPPPPPPPPPPPPPPPPPPPPPPPPPPPPPPPP
PB C                                                                     P
P                                                                        P
PPPP                                                                     P
P    P                U                                                  P
P                    PP                                                  P
PU                  P                                                    P
PPPP       PPFFPPP                                                       P
P   P  PP    PP                                                          P
P                                                                        P
P                      P                                                 P
P                  PPPP FFF                                              P
P                       PPP                                              P
P                           PP  PPP                                      P
P                              UP   FF                                   P
P                              PP   PPPP                                 P
P                               P       PP   P               P           P
P                               P             P                          P                                               
PFFFFFFFFFFFFFFFFFFFFFFFFFFFFFFFPFFFFFFFFFFFFFFP     P    P  U  P        P
PPPPPPPPPPPPPPPPPPPPPPPPPPPPPPPPPPPPPPPPPPPPPPPPPPPPPPPPPPPPPPPPPPPPPPPPPP
