PPPPPPPPPPPPPPPPPPPPPPPPPPPPPPPPPPPPPPPPPPPPPPPPPPPPPPPPPPPPPPPPPPPPPPPPPPPPPPPPPPPPPPP
P                                                                                     P
P                                                                                     P
P                                                                                     P
P                                                                                     P
P                                                                                     P
P                                                                                     P
P                                                            P  E  P                  P
P                                                         PPPPPPPPP                   P
P                                                      P                              P
P                                                                                     P
P                                                       P                             P
P                                                                E                    P
P                                                        P        P                   P
P                                                              P                      P
P                                                         P                           P
P         E                                                   P                       P
P         PP                                               P                          P
PC     P                       P                             P                        P
P         E                  P         E                                             UP
PPPPPPPPPPPPPPPP  PPPPPPPPPPPPPPPPP  PPPPPPPPPPPPPPPPP  PPPPPPPPPPPPPPPPP  PPPPPPPPPPPP
               P UP               P  P               P  P               P  P
               P PP               P  P               P  P               P  P
               P  P               P  P               P  P               P  P
               P  P               P  P               P  P               P  P
               P  P               P  P               P  P               P  P
               P  P               P  P               P  P               P  PPPPPPPPPPPPPPPP
               PFFP               PFFP               PFFP               P                 P
               PPPP               PPPP               PPPP               P                 P
                                                                        P                 P
                                                                        P                BP
                                                                        PPPPPPPPPPPPPPPPPPP

                                                                 
          